cust_id,type
100001,1
100002,2
100003,3
100004,4
100005,5
